info {
bg:1;
}

tiles {
1,1,1,1,1,1,1,1,55,56,1,1,1,1,1,1,1,1,1,1,1,1,1,1,1,1,1,1,1,1,1,1,1,1,1,1,1,1,1,1
1,1,1,1,1,1,29,17,17,17,17,17,17,5,1,1,1,1,1,1,1,1,1,1,1,57,58,59,60,61,62,1,1,1,1,1,1,1,1,1
1,1,1,1,1,29,21,0,0,0,0,0,0,7,17,17,17,17,17,17,5,17,17,17,17,17,17,17,17,17,17,17,17,17,17,17,27,1,1,1
1,1,1,1,29,21,0,0,0,0,0,0,0,0,0,0,0,0,0,0,0,0,0,0,0,0,0,0,0,0,0,0,0,0,0,0,15,1,1,1
1,1,1,29,21,0,0,3,0,0,7,0,0,0,0,0,0,0,0,0,0,0,0,0,0,0,0,0,0,0,0,0,0,0,0,0,20,28,1,1
1,1,1,14,0,0,0,0,0,0,5,0,0,0,0,0,0,0,0,0,0,0,0,0,0,0,0,0,0,0,0,0,0,0,0,52,2,51,40,1
1,1,1,14,0,0,7,5,0,0,0,0,0,0,0,0,19,16,16,16,7,18,19,16,16,16,18,0,0,19,16,16,16,5,7,2,13,2,33,1
1,1,1,14,0,0,5,7,0,0,0,0,0,0,5,7,5,1,1,1,1,14,15,55,56,1,14,0,0,15,1,1,1,1,32,2,2,2,33,1
1,1,1,14,0,0,0,0,0,0,0,0,0,0,0,0,15,1,1,1,1,14,15,1,1,1,24,16,18,20,28,1,1,1,32,2,2,2,33,1
1,1,1,14,0,0,0,0,0,0,0,0,0,0,0,19,30,1,1,1,1,14,15,1,1,1,1,1,31,18,20,28,1,1,32,12,2,2,33,1
1,1,1,24,16,16,18,0,0,0,19,16,7,16,16,30,1,1,1,1,29,21,20,28,1,1,1,1,1,31,18,15,1,1,32,2,2,2,33,1
1,1,1,1,1,1,7,0,0,5,7,55,56,1,1,1,1,1,1,1,14,0,0,15,1,1,1,1,1,1,14,15,1,1,32,2,4,2,33,1
1,1,1,1,1,1,14,0,0,0,15,1,1,1,1,1,1,1,1,1,14,0,0,15,1,1,1,1,1,1,14,15,1,1,32,2,2,6,6,1
1,1,1,1,1,1,14,0,0,0,15,1,1,1,1,1,1,1,1,1,14,0,0,15,1,1,1,1,1,1,14,15,1,1,32,2,2,2,33,1
1,1,1,1,1,1,14,0,0,0,15,1,1,1,1,1,1,1,1,1,14,0,0,15,1,1,1,1,1,1,14,15,1,1,48,10,10,10,47,1
1,1,1,1,1,1,14,0,0,0,15,1,1,1,1,1,1,1,1,29,21,0,0,20,28,1,1,1,1,1,14,15,1,1,14,0,0,0,15,1
1,1,1,1,1,1,14,0,0,0,15,1,1,1,1,1,1,1,1,14,0,7,5,0,15,1,1,1,1,1,32,33,1,1,14,19,16,18,15,1
1,1,1,1,1,29,21,0,0,19,30,1,1,1,1,1,1,1,1,14,0,5,7,0,15,1,1,1,1,1,32,33,1,1,14,15,1,14,15,1
1,1,1,1,29,21,0,0,19,30,1,1,1,1,1,1,1,1,1,14,0,0,0,0,15,1,1,1,1,1,32,33,1,1,14,15,1,14,15,1
1,1,1,29,21,0,0,19,30,1,1,1,1,1,1,1,1,1,1,14,0,0,0,0,15,1,1,1,1,1,32,51,35,54,21,15,1,14,15,1
1,1,29,21,0,0,19,30,1,1,1,1,1,1,1,1,1,1,1,14,0,0,0,0,15,1,1,1,1,1,41,34,34,54,18,15,1,14,15,1
1,29,21,0,0,19,30,1,1,1,1,1,1,1,1,1,1,1,1,31,18,0,0,19,30,1,1,1,1,1,1,1,1,1,14,15,1,14,15,1
1,14,0,0,19,30,1,1,1,1,1,1,1,1,1,55,56,1,1,1,5,0,0,7,1,1,1,1,1,1,1,1,1,1,14,15,1,14,15,1
1,14,0,0,15,1,1,1,1,1,1,29,17,17,17,17,17,7,17,17,21,0,0,20,17,17,17,17,27,1,1,1,1,1,14,15,1,14,15,1
1,14,0,0,15,1,1,1,1,1,29,21,0,0,0,0,0,5,0,0,0,0,0,0,0,0,0,0,15,1,1,1,1,29,21,15,1,14,15,1
1,7,5,0,15,1,1,1,1,29,21,19,16,16,16,16,16,16,18,0,0,0,0,0,0,0,0,0,15,1,1,1,29,21,19,30,1,14,15,1
1,5,7,0,15,1,1,1,29,21,19,30,1,1,1,1,1,1,24,16,16,16,16,16,16,16,18,0,15,55,56,29,21,19,30,1,1,14,15,1
1,14,0,0,15,1,29,17,21,19,30,1,39,35,35,40,1,1,1,1,1,1,1,1,1,1,7,0,20,17,17,21,19,30,1,1,1,14,15,1
1,14,0,0,20,7,21,0,0,15,1,1,32,2,2,33,1,1,1,1,1,1,1,1,1,1,14,0,19,16,16,16,30,1,1,1,1,14,15,1
1,14,0,0,0,0,0,0,0,20,28,1,32,2,2,33,57,58,59,1,1,1,1,1,1,1,14,0,5,1,1,1,1,1,1,1,1,14,15,1
1,14,0,0,0,0,0,0,0,0,15,1,32,2,2,33,60,61,62,1,1,1,1,1,1,1,14,0,15,1,1,1,1,1,1,1,1,14,15,1
1,24,16,16,16,5,18,0,0,0,15,1,32,2,2,51,43,17,17,17,27,1,1,1,1,1,14,0,15,1,1,1,1,1,1,1,1,14,15,1
1,1,1,1,1,1,31,18,0,0,15,1,32,2,2,2,53,0,0,0,15,1,1,1,1,1,7,0,15,1,1,1,1,1,1,1,1,14,15,1
1,1,1,1,1,55,56,14,0,0,15,1,48,10,10,10,23,0,0,0,15,1,1,1,1,1,14,0,15,1,1,1,1,1,1,1,1,14,15,1
1,1,1,1,26,17,17,21,0,0,20,44,14,0,0,0,0,0,0,0,15,55,56,1,1,1,14,0,15,1,1,1,1,29,17,17,17,21,15,1
1,1,1,1,14,0,0,0,0,7,0,9,14,0,0,0,0,0,0,0,20,17,17,17,17,17,21,0,20,28,1,1,1,14,3,0,0,19,30,1
1,1,1,1,14,0,0,0,0,0,0,9,14,0,0,0,5,0,0,0,0,0,0,0,0,0,0,0,0,20,28,1,1,14,0,0,0,15,1,1
1,1,1,1,49,11,11,22,0,0,0,0,53,0,0,5,7,0,0,0,19,16,16,16,16,16,16,16,5,18,20,28,1,7,5,0,0,15,1,1
1,36,35,35,50,2,2,8,0,0,0,0,53,0,0,0,0,0,0,0,15,1,1,1,1,1,1,1,1,31,18,20,28,14,0,0,0,15,1,1
1,32,2,2,2,2,2,8,0,0,0,9,14,0,0,19,16,16,16,16,25,1,1,1,1,1,1,1,1,1,31,18,20,21,0,0,0,15,1,1
1,32,4,2,2,2,2,8,0,0,0,9,14,0,19,30,1,1,1,1,1,1,1,1,1,1,1,1,1,1,1,31,16,16,16,16,16,30,1,1
1,38,34,34,34,34,34,45,16,16,16,46,24,16,30,1,1,1,1,1,1,1,1,1,1,1,1,1,1,1,1,1,1,1,1,55,56,1,1,1
1,1,1,1,1,1,1,1,1,1,1,1,1,1,1,1,1,1,1,1,1,1,1,1,1,1,1,1,1,1,1,1,1,1,1,1,1,1,1,1
}

collision {
(96,32),(64,64),(96,32)
(224,352),(224,384),(192,384),(192,544),(32,704),(32,800),(96,800),(96,864),(32,864),(32,1024),(160,1024),(160,992),(192,992),(192,1024),(224,1056),(224,1088),(128,1088),(128,1216),(32,1216),(32,1344),(448,1344),(512,1280),(672,1280),(672,1216),(896,1216),(896,1184),(928,1184),(928,1216),(1024,1312),(1184,1312),(1216,1280),(1216,1152),(1248,1120),(1248,416),(1184,416),(1184,384),(1248,384),(1248,192),(1184,128),(1184,64),(672,64),(672,96),(640,96),(640,64),(448,64),(448,96),(416,96),(416,32),(224,32),(96,160),(96,352),(224,352)
(192,256),(256,256),(256,192),(192,192),(192,256)
(352,192),(352,128),(320,128),(320,192),(352,192)
(448,256),(544,256),(544,224),(448,224),(448,256)
(416,352),(416,320),(416,320),(384,320),(384,352),(416,352)
(352,384),(352,416),(384,416),(384,352),(288,352),(288,384),(352,384)
(352,384),(352,544),(160,736),(160,896),(160,928),(192,928),(192,896),(224,864),(256,864),(384,736),(544,736),(544,800),(576,800),(576,736),(672,736),(672,704),(640,704),(608,672),(608,512),(640,480),(640,352),(672,320),(672,192),(640,192),(640,224),(512,224),(512,256),(544,256),(544,288),(480,352),(352,352),(352,384)
(320,928),(320,928),(352,960),(352,1088),(376,1088),(376,1184),(384,1184),(384,896),(416,864),(480,864),(512,896),(512,992),(672,992),(672,1120),(832,1120),(832,1056),(864,1056),(864,1024),(832,1024),(832,896),(864,896),(864,864),(576,864),(576,832),(384,832),(320,896),(320,928)
(376,1360),(384,1352),(384,1248),(376,1248),(376,1360)
(320,1152),(320,1120),(288,1120),(288,1152),(320,1152)
(544,1216),(544,1152),(512,1152),(512,1184),(480,1184),(480,1216),(544,1216)
(1056,224),(960,224),(960,256),(1024,320),(1024,608),(1088,608),(1088,224),(1120,224),(1120,192),(1056,192),(1056,224)
(1152,800),(1024,928),(896,928),(896,960),(928,960),(928,1120),(1056,1248),(1056,1216),(1120,1216),(1120,1184),(1056,1184),(1056,1120),(1088,1088),(1184,1088),(1184,544),(1152,544),(1152,800)
(736,320),(768,352),(768,480),(800,512),(800,672),(768,704),(736,704),(736,736),(928,736),(928,864),(992,864),(1088,768),(1088,672),(992,672),(960,640),(960,352),(896,288),(832,288),(832,224),(736,224),(736,320)
(672,576),(736,576),(736,512),(672,512),(672,576)
}

collisionPeople {
(120,1216),(160,1216),(160,1208),(120,1208),(120,1216)
(224,1360),(232,1360),(232,1208),(224,1208),(224,1360)
(376,1064),(520,1064),(520,1056),(376,1056),(376,1064)
(520,1024),(520,976),(512,976),(512,1024),(520,1024)
(1072,440),(1080,456),(1256,456),(1256,448),(1088,448),(1072,440)
(1138,305),(1141,308),(1138,312),(1134,308),(1138,305)
(1132,295),(1130,293),(1128,296),(1131,299),(1132,295)
(1168,212),(1164,211),(1161,214),(1164,218),(1168,212)
(1173,203),(1175,200),(1172,197),(1168,200),(1173,203)
}

buyzones {
(0,736,64,768,96)
(0,736,64,768,96)
(0,736,64,768,96)
(0,736,48,992,176)
(1,384,864,512,1056)
}

spawns {
(2,896,768);(2,1104,1136);(2,80,1296);(2,448,912);(2,704,592);(2,496,288);(2,128,320);(2,864,256);(2,1216,352);(2,1152,96);(2,992,640);(2,640,1248);(2,64,768);(1,416,928);(1,480,928);(1,448,896);(1,448,960);(1,416,976);(1,480,976);(1,448,1008);(1,480,1024);(1,416,1024);(0,768,144);(0,816,144);(0,864,144);(0,912,144);(0,960,128);(0,912,96);(0,864,96);(0,816,96);(0,768,96)
}

waypoints {
}

guns {
(23,240,144);(23,1168,368);(23,1104,1136);(23,80,1296);(18,416,928);(18,480,928);(18,480,976);(18,416,976);(18,416,1024);(18,480,1024);(18,448,896);(18,448,960);(18,448,1008);(17,768,96);(17,768,144);(17,816,144);(17,864,144);(17,912,144);(17,816,96);(17,864,96);(17,912,96);(17,960,128);(26,768,96);(26,816,96);(26,864,96);(26,912,96);(26,960,128);(26,912,144);(26,864,144);(26,816,144);(26,768,144);(26,416,1024);(26,448,1008);(26,480,1024);(26,480,976);(26,448,960);(26,416,976);(26,416,928);(26,480,928);(26,448,896)
}
