tiles {
48,48,48,48,48,48,48,48,48,48,48,43,44,44,44,44,44,44,44,44,44,44,44,44,43,48,54,55,55,55,55,55,55,55,55,55,55,55,54,48,48,48,181,181,181,181,181,48,48,48,48,48,48,48,48,48,48,48,48,48,48,48,48,48,48,48,48,48,48,48,48,48,48,48,48,48,48,48,48,48,181,181,181,181,181,181,181,181,181,181,181,48,48,48,48,48,48,48,48,48
48,48,48,48,48,48,48,48,48,48,48,43,44,174,174,174,44,44,44,44,174,174,174,44,43,48,138,54,54,54,54,54,54,54,54,54,54,54,138,48,48,181,179,179,179,179,179,181,48,48,48,48,48,48,48,48,48,48,48,48,48,48,48,48,48,48,48,48,48,48,48,48,48,48,48,48,48,48,48,181,179,179,179,179,179,179,179,179,179,179,179,181,48,48,48,48,48,48,48,48
48,48,48,48,48,48,48,48,48,48,48,43,44,174,174,174,44,44,44,44,174,174,174,44,43,48,43,44,44,44,44,44,44,44,44,44,44,44,43,48,48,181,179,179,179,179,179,181,48,48,48,48,48,48,48,48,48,48,48,48,48,48,48,48,48,48,48,48,48,48,48,48,48,48,48,48,48,48,48,181,179,179,179,179,179,179,179,179,179,179,179,179,181,48,48,48,48,48,48,48
48,48,48,48,48,48,48,48,48,48,48,43,44,44,44,44,44,44,44,44,44,44,44,44,43,48,43,44,174,174,44,44,44,44,44,174,174,44,43,48,48,48,181,179,179,179,181,48,48,48,48,48,48,48,48,48,48,48,48,48,48,48,48,48,48,48,48,48,48,48,48,48,48,48,48,48,48,48,48,181,179,179,179,179,179,179,179,179,179,179,179,179,181,48,48,48,48,48,48,48
48,48,48,48,48,48,48,48,48,48,48,43,44,44,44,44,44,15,15,44,44,44,44,44,43,48,43,44,174,174,44,44,15,15,44,174,174,44,43,48,48,48,181,179,179,179,181,48,48,48,48,48,48,48,48,48,48,48,48,48,48,48,48,48,48,48,48,48,48,48,48,48,48,48,48,48,48,48,48,181,179,179,179,179,179,179,179,179,179,179,179,179,179,181,48,48,48,48,48,48
48,48,48,48,181,181,181,181,181,48,48,43,44,44,44,44,44,15,2,44,44,44,44,44,43,48,43,44,44,44,44,44,15,2,44,44,44,44,43,48,48,48,181,179,179,179,181,48,48,48,48,48,48,48,48,48,48,48,48,48,48,48,48,48,48,48,48,48,48,48,48,48,48,48,48,48,48,48,48,181,179,179,179,179,179,179,181,181,181,181,179,179,179,179,181,48,48,48,48,48
48,48,48,181,179,179,179,179,179,181,48,43,44,44,44,44,44,15,15,44,44,44,44,44,43,48,43,44,44,44,44,44,15,15,44,44,44,44,43,48,48,48,181,179,179,179,181,48,48,48,48,48,48,48,48,48,48,48,48,48,48,48,48,48,48,48,48,48,48,48,48,48,48,48,48,48,48,48,48,181,179,179,179,179,179,181,48,48,48,181,179,179,179,179,179,181,48,48,48,48
48,48,48,181,179,179,179,179,179,179,181,181,181,181,181,181,181,181,181,181,181,181,181,181,181,181,181,181,181,181,181,181,181,181,181,181,181,181,181,181,181,181,179,179,179,179,179,181,181,181,181,181,181,181,181,181,181,181,181,181,48,48,48,48,48,48,48,48,48,48,48,48,48,48,48,48,48,48,48,181,179,179,179,179,181,48,48,48,48,48,181,179,179,179,179,179,181,48,48,48
48,48,48,181,179,179,179,179,179,179,179,179,179,179,179,179,179,179,179,179,179,179,179,179,179,179,179,179,179,179,179,179,179,179,179,179,179,179,179,179,179,179,179,179,179,179,179,179,179,179,179,179,179,179,179,179,179,179,179,179,181,48,48,48,48,48,48,48,48,48,48,48,48,48,48,48,48,48,48,181,179,179,179,179,181,48,48,48,48,48,48,181,179,179,179,179,181,48,48,48
48,48,48,181,179,179,179,179,179,179,179,179,179,179,179,179,179,179,179,179,179,179,179,179,179,179,179,179,179,179,179,179,179,179,179,179,179,179,179,179,179,179,179,179,179,179,179,179,179,179,179,179,179,179,179,179,179,179,179,179,179,181,48,48,48,48,48,48,48,48,48,48,48,48,48,48,48,48,48,181,179,179,179,179,181,48,48,48,48,48,48,181,179,179,179,179,181,48,48,48
48,48,48,181,179,179,179,179,179,179,181,181,181,181,181,181,181,181,181,181,181,181,181,181,181,181,181,181,181,181,181,181,181,181,179,179,179,179,179,179,179,179,179,179,179,179,179,179,179,179,179,179,179,179,179,179,179,179,179,179,179,179,181,48,48,48,48,48,48,48,48,48,48,48,48,48,48,48,48,48,181,181,181,181,48,48,48,48,48,48,48,181,179,179,179,179,181,48,48,48
48,48,48,181,179,179,179,179,179,181,138,54,54,54,54,54,54,54,54,54,54,54,54,138,48,48,48,48,48,48,48,48,48,181,179,179,179,179,179,179,179,179,179,179,179,179,179,179,179,179,179,179,179,179,179,179,179,179,179,179,179,179,179,181,48,48,48,48,48,48,48,48,48,48,48,48,48,48,48,48,48,48,48,48,48,48,48,48,48,48,181,179,179,179,179,179,181,48,48,48
48,48,48,48,181,181,181,181,181,48,54,55,55,55,55,55,55,55,55,55,55,55,55,54,48,48,48,48,48,48,48,48,48,181,179,179,179,179,179,179,179,179,181,181,181,181,181,181,181,181,181,181,181,181,181,181,181,181,181,179,179,179,179,179,181,48,48,48,48,48,48,48,48,48,48,48,48,48,48,48,48,48,48,48,48,48,48,48,48,181,179,179,179,179,179,181,48,48,48,48
48,48,48,48,48,48,48,48,48,48,54,55,55,55,55,55,55,55,55,55,55,55,55,54,48,48,48,48,48,48,48,48,48,181,179,179,179,179,179,179,179,181,48,48,48,48,48,48,48,48,48,48,48,48,48,48,48,48,48,181,179,179,179,179,179,181,181,181,181,181,181,181,181,181,181,181,181,181,181,181,181,181,181,181,181,181,181,181,181,179,179,179,179,179,181,48,48,48,48,48
48,48,48,48,48,48,48,48,48,48,54,55,55,55,55,55,55,55,55,55,55,55,55,54,48,48,48,48,48,48,48,48,48,181,179,179,179,179,179,179,179,181,48,48,48,48,48,48,48,48,48,48,48,48,48,48,48,48,48,48,181,179,179,179,179,179,179,179,179,179,179,179,179,179,179,179,179,179,179,179,179,179,179,179,179,179,179,179,179,179,179,179,179,181,48,48,48,48,48,48
48,48,48,48,48,48,48,48,48,48,54,55,55,55,55,55,55,55,55,55,55,55,55,54,48,48,48,48,48,48,48,48,48,181,179,179,179,179,179,179,179,181,48,48,48,48,48,48,48,48,48,48,48,48,48,48,48,48,48,48,48,181,179,179,179,179,179,179,179,179,179,179,179,179,179,179,179,179,179,179,179,179,179,179,179,179,179,179,179,179,179,179,181,48,48,48,48,48,48,48
48,48,48,48,48,48,48,48,48,48,138,54,54,54,54,54,54,54,54,54,54,54,54,138,48,48,48,48,48,48,48,48,48,181,179,179,179,179,179,179,179,181,48,48,48,48,48,48,48,48,48,48,48,48,48,48,48,48,48,48,48,48,181,179,179,179,179,179,179,179,179,179,179,179,179,179,179,179,179,179,179,179,179,179,179,179,179,179,179,179,179,181,48,48,48,48,48,48,48,48
48,48,48,48,48,48,48,48,48,48,43,44,44,44,44,44,44,44,44,44,44,44,44,43,48,48,48,48,48,48,48,48,48,181,179,179,179,179,179,179,179,181,48,48,48,48,48,48,48,48,48,48,48,48,48,48,48,48,48,48,48,48,48,181,179,179,179,179,179,179,179,179,179,179,179,179,179,179,179,179,179,179,179,179,179,179,179,179,179,179,181,48,48,48,48,48,48,48,48,48
48,48,48,48,48,48,48,48,48,48,43,44,174,174,44,44,44,44,44,44,174,174,44,43,48,48,48,48,48,48,48,48,48,181,179,179,179,179,179,179,179,181,48,48,48,48,48,48,48,48,48,48,48,48,48,48,48,48,48,48,48,48,48,48,181,181,181,181,181,181,181,181,181,181,181,181,181,181,181,181,181,181,181,181,181,181,181,181,181,181,48,48,48,48,48,48,48,48,48,48
48,48,48,48,48,48,48,48,48,48,43,44,174,174,44,44,44,44,44,44,174,174,44,43,48,48,48,48,48,48,48,48,48,181,179,179,179,179,179,179,179,181,48,48,48,48,48,48,48,48,48,48,48,48,48,48,48,48,48,48,48,48,48,48,48,48,48,48,48,48,48,48,48,48,48,48,48,48,48,48,48,48,48,48,48,48,48,48,48,48,48,48,48,48,48,48,48,48,48,48
48,48,48,48,48,48,48,48,48,48,43,44,44,44,44,44,15,15,44,44,44,44,44,43,48,48,48,48,48,48,48,48,48,181,179,179,179,179,179,179,179,181,48,48,48,48,48,48,48,48,48,48,48,48,48,48,48,48,48,48,48,48,48,48,48,48,48,48,48,48,48,48,48,48,48,48,48,48,48,48,48,48,48,48,48,48,48,48,48,48,48,48,48,48,48,48,48,48,48,48
48,48,48,48,48,48,48,48,48,48,43,44,44,44,44,44,15,2,44,44,44,44,44,43,48,48,48,48,48,181,181,181,181,179,179,179,179,179,179,179,179,179,181,181,181,181,48,48,48,48,48,48,48,48,48,48,48,48,48,48,48,48,48,48,48,48,48,48,48,48,48,48,48,48,48,48,48,48,48,48,48,48,48,48,48,48,48,48,48,48,48,48,48,48,48,48,48,48,48,48
48,48,48,48,48,48,48,48,48,48,43,44,44,44,44,44,15,15,44,44,44,44,44,43,48,48,48,48,181,179,179,179,179,179,179,179,155,155,179,179,179,179,179,179,179,179,181,48,48,48,48,48,48,48,48,48,48,48,48,48,48,48,48,48,48,48,48,48,48,48,48,48,48,48,48,48,48,48,48,48,48,48,48,48,48,48,48,48,48,48,48,48,48,48,48,48,48,48,48,48
48,48,48,48,181,181,181,181,181,181,181,181,181,181,181,181,181,181,181,181,181,181,48,48,48,48,48,181,179,179,179,179,155,155,155,155,179,179,179,179,179,179,179,179,179,179,179,181,48,48,48,48,48,48,48,48,48,48,48,48,48,48,48,48,48,48,48,48,48,48,48,48,48,138,54,54,54,54,54,54,54,54,54,54,54,54,54,54,54,54,54,54,54,54,54,54,138,48,48,48
48,48,48,181,179,179,179,179,179,179,179,179,179,179,179,179,179,179,179,179,179,179,181,48,48,48,181,179,179,179,179,179,179,179,179,179,179,179,179,179,179,179,179,155,155,155,155,155,181,0,0,0,0,0,0,0,0,0,0,0,48,48,48,48,48,48,48,48,48,48,48,48,48,54,55,55,55,55,55,55,55,55,55,55,55,55,55,55,55,55,55,55,55,55,55,55,54,48,48,0
48,48,181,155,179,179,179,179,179,179,179,179,179,179,179,179,179,179,179,179,179,179,181,48,48,181,179,179,179,179,179,179,179,179,179,179,179,179,179,179,179,179,179,179,179,179,179,179,179,181,0,0,0,0,0,0,0,0,0,0,0,0,0,0,0,0,0,0,0,0,0,48,48,54,55,55,55,55,55,55,55,55,55,55,55,55,55,55,55,55,55,55,55,55,55,55,54,48,48,0
48,181,179,179,179,179,179,179,179,179,179,179,179,179,179,179,179,179,179,179,179,179,181,48,181,179,179,179,179,155,155,155,179,179,179,179,179,179,179,179,179,179,179,179,179,179,179,179,179,179,181,0,0,0,0,0,0,0,0,0,0,0,0,0,0,0,0,0,0,0,0,48,48,54,55,55,55,55,55,55,55,55,55,55,55,55,55,55,55,55,55,55,55,55,55,55,54,48,48,0
48,181,179,179,179,179,179,181,181,181,181,181,181,181,181,181,181,181,181,181,181,181,48,181,179,179,179,179,179,155,155,155,179,179,179,179,179,179,179,179,179,155,155,155,179,179,179,179,179,179,179,181,0,0,0,0,0,0,0,0,0,0,0,0,0,0,0,0,0,0,0,48,48,54,55,55,55,55,55,55,55,55,55,55,55,55,55,55,55,55,55,55,55,55,55,55,54,48,48,0
48,181,179,179,179,155,181,48,48,138,54,54,54,54,54,54,54,138,48,48,48,48,181,179,179,179,179,179,179,179,179,179,179,179,179,179,179,179,179,179,179,155,155,155,179,179,179,179,179,179,179,179,181,0,0,0,0,0,0,0,0,0,0,0,0,0,0,0,0,0,0,48,48,54,55,55,55,55,55,55,55,55,55,42,42,55,55,55,55,55,55,55,55,55,55,55,54,48,48,0
48,181,179,179,179,179,181,48,48,54,55,55,55,55,55,55,55,54,48,48,48,181,179,179,179,179,179,179,179,179,179,179,179,179,179,179,179,179,179,179,179,179,179,179,179,179,179,179,155,155,179,179,179,181,0,0,0,0,0,0,0,0,0,0,0,0,0,0,0,0,0,48,48,54,55,55,55,55,55,55,55,42,42,42,42,42,55,42,55,55,55,55,55,55,55,55,54,48,48,0
48,181,179,179,179,179,181,48,48,54,55,55,55,55,55,55,55,54,48,48,181,179,179,179,179,179,179,179,179,155,155,179,179,179,179,179,179,179,179,179,179,179,179,179,179,179,179,179,155,155,179,179,179,179,181,0,0,0,0,0,0,0,0,0,0,0,0,0,0,0,0,48,48,138,54,54,54,54,54,54,42,42,42,17,17,17,42,42,54,54,54,54,54,54,54,54,138,48,48,0
48,181,179,179,179,179,181,48,48,138,54,54,54,54,54,54,54,138,48,181,179,179,179,179,179,179,179,179,179,155,155,179,179,179,179,179,179,179,179,179,179,179,179,179,179,179,179,179,179,179,179,179,179,179,179,181,0,0,0,0,0,0,0,0,0,0,0,0,0,0,0,48,48,43,44,93,42,42,42,42,14,14,42,17,17,17,42,11,11,42,42,42,42,42,44,44,43,48,48,0
48,181,179,179,179,155,181,48,48,43,141,141,141,141,141,141,141,43,48,181,179,179,179,155,179,179,179,179,179,179,179,179,179,179,179,179,179,155,155,155,179,179,179,179,179,179,179,179,179,179,179,179,179,179,179,181,0,0,0,0,0,0,0,0,0,0,0,0,0,0,0,48,48,43,44,44,93,42,42,42,11,11,42,42,42,42,42,12,12,42,42,42,42,93,44,44,43,48,48,0
48,181,179,179,179,179,181,48,48,43,44,44,44,105,44,44,44,43,48,181,179,179,179,155,179,179,179,179,179,179,179,179,179,179,179,179,179,179,179,155,179,179,179,179,155,179,179,179,179,179,155,179,179,179,179,181,0,0,0,0,0,0,0,0,0,0,0,0,0,0,0,48,48,43,44,44,93,42,42,42,14,14,42,42,42,42,42,13,13,42,42,42,93,44,42,44,43,48,48,0
48,181,179,179,179,179,181,181,48,43,44,44,44,109,44,44,44,43,48,181,179,179,179,155,155,179,179,179,179,179,179,179,179,179,179,179,179,179,179,155,179,179,179,179,179,155,179,179,179,179,155,179,179,179,179,181,0,0,0,0,0,0,0,0,0,0,0,0,0,0,0,48,48,43,44,44,139,93,93,42,42,42,42,42,42,42,42,42,42,42,93,93,44,44,42,93,43,48,48,0
48,181,179,179,179,179,179,181,181,181,181,181,181,181,181,181,181,181,181,179,179,179,179,155,155,179,179,179,179,179,179,179,179,179,179,179,179,179,179,155,179,179,179,179,179,155,179,179,179,179,155,179,179,179,179,179,181,181,181,181,181,181,181,181,181,181,181,181,0,0,0,48,48,43,44,44,44,93,17,17,17,42,42,42,42,42,42,42,42,42,93,139,44,44,93,44,43,48,48,0
0,181,179,179,179,179,179,179,179,179,179,179,179,155,179,179,179,179,179,179,179,179,179,155,155,179,179,179,179,179,179,155,179,179,179,179,179,179,179,155,179,179,179,179,155,179,179,179,179,179,155,179,179,179,179,179,179,179,179,179,179,179,179,179,179,179,179,179,181,0,0,48,48,43,44,93,42,93,17,16,17,42,42,42,100,42,42,42,93,93,44,44,42,93,44,44,43,48,48,0
0,181,155,155,179,179,179,179,179,179,179,179,179,155,179,179,179,179,179,179,179,179,179,179,179,179,179,179,179,179,179,155,179,179,179,179,179,179,179,179,179,179,179,155,179,179,179,179,179,179,179,179,179,179,179,179,179,179,179,179,179,179,179,179,179,179,179,179,179,181,0,48,48,43,44,93,93,44,93,42,42,42,42,42,42,42,42,93,44,44,44,42,42,93,44,44,43,48,48,0
0,181,179,179,179,179,179,179,179,179,179,179,179,155,179,179,179,179,179,179,179,179,179,179,179,179,179,179,179,179,179,155,179,179,179,179,179,179,179,179,179,179,155,179,179,179,179,179,179,179,179,179,179,179,179,179,179,179,179,179,179,179,179,179,179,179,179,179,179,179,181,48,48,43,44,44,44,44,44,93,93,93,93,93,15,42,42,44,44,44,93,93,93,44,44,44,43,48,181,0
0,181,179,179,179,179,179,179,179,179,179,179,179,179,179,179,179,179,179,179,179,179,179,179,179,179,179,179,179,179,179,179,179,179,179,179,179,179,179,179,179,179,179,179,179,179,179,179,179,179,179,179,179,179,179,179,179,179,179,179,179,179,179,179,179,179,179,179,179,179,181,48,48,43,44,44,44,93,42,42,44,44,44,44,15,42,93,44,44,44,44,44,44,44,44,44,43,181,179,181
0,0,0,0,0,179,179,179,179,179,179,179,179,179,179,179,179,179,179,179,179,179,179,179,179,179,179,179,179,179,179,179,179,179,179,179,179,179,179,179,179,179,179,179,179,179,179,155,155,155,179,179,179,179,179,179,179,179,179,179,179,179,179,179,179,179,179,179,179,179,181,48,48,43,44,44,44,44,93,93,44,44,44,44,15,15,44,44,44,44,44,44,44,44,44,44,43,181,179,181
0,0,0,0,0,0,0,179,179,179,179,179,179,179,179,179,179,179,179,179,179,179,179,179,179,179,179,179,179,179,179,155,179,179,179,179,179,179,179,179,179,179,179,179,179,179,179,155,179,179,179,179,179,179,179,179,179,179,179,179,179,179,179,179,179,179,179,179,179,179,179,181,181,181,181,181,181,181,181,181,181,181,181,181,181,181,181,181,181,181,181,181,181,181,181,181,181,179,179,181
0,0,0,0,0,0,0,179,179,179,179,179,179,179,179,179,179,179,179,179,179,179,179,179,179,179,179,179,179,179,179,179,155,179,179,179,179,179,179,179,179,179,179,179,179,179,179,155,179,179,179,179,179,179,179,179,179,179,179,179,179,179,179,179,179,179,179,179,179,179,179,179,179,179,179,179,179,179,179,179,179,179,179,179,179,179,179,179,179,179,179,179,179,179,179,179,179,179,179,181
0,0,0,0,0,0,0,0,0,0,0,0,0,0,0,0,181,181,181,179,179,179,179,179,179,179,179,179,179,179,179,179,179,155,179,179,179,179,179,179,179,179,179,179,179,179,179,155,155,155,155,179,179,179,179,179,181,181,181,181,179,179,179,179,179,179,179,179,179,179,179,179,179,179,179,179,179,179,179,179,179,179,179,179,179,179,179,179,179,179,179,179,179,179,179,179,179,179,179,181
0,0,0,0,0,0,0,0,0,0,0,0,0,0,0,0,48,48,48,181,179,179,179,179,179,155,155,179,179,179,179,179,179,179,155,179,179,179,179,179,179,179,179,179,179,179,179,179,179,179,155,179,179,179,179,181,0,0,0,181,179,179,179,179,179,179,179,179,179,179,179,179,179,179,179,179,179,179,179,179,179,179,179,179,179,179,179,179,179,179,179,179,179,179,179,179,179,179,179,181
0,0,0,0,0,0,0,0,0,0,0,0,0,0,0,0,48,48,48,181,179,179,179,179,179,179,155,155,179,179,179,179,179,179,155,179,179,179,179,179,155,155,179,179,179,179,179,179,179,179,155,179,179,179,179,181,0,0,0,181,179,179,179,179,179,179,179,179,179,181,181,181,181,181,181,181,181,181,181,181,181,181,181,181,181,181,181,181,181,181,181,181,181,181,181,181,181,181,181,48
0,0,0,0,0,0,0,0,0,0,0,0,0,0,0,0,48,48,48,181,179,179,179,179,179,179,179,155,155,179,179,179,179,179,179,179,179,179,179,155,146,146,155,179,179,179,155,155,155,155,155,179,179,179,179,181,0,0,0,0,181,179,179,179,179,179,179,179,181,48,48,48,48,48,48,48,48,48,48,48,48,48,48,48,48,48,48,48,48,48,48,48,48,48,48,48,48,48,48,48
0,0,0,0,0,0,0,0,0,0,0,0,0,0,0,0,48,48,48,181,179,179,179,179,179,179,179,179,155,179,179,179,179,179,179,179,179,179,179,155,146,146,155,179,179,179,179,179,179,179,179,179,179,179,179,181,0,0,0,0,0,181,179,179,179,179,179,179,179,181,48,48,48,48,48,48,48,48,48,48,48,48,48,48,48,48,48,48,48,48,48,48,48,48,48,48,48,48,48,48
0,0,0,0,0,0,0,0,0,0,0,0,0,0,0,0,48,48,48,48,181,179,179,179,179,179,179,179,179,179,179,179,179,179,179,179,179,179,179,179,179,179,179,179,179,179,179,179,179,179,179,179,179,179,181,48,0,0,0,0,0,0,181,179,179,179,179,179,179,179,181,48,48,48,48,48,48,48,48,48,48,48,48,48,48,48,48,48,48,48,48,48,48,48,48,48,48,48,48,48
0,0,0,0,0,0,0,0,0,0,0,0,0,0,0,0,0,0,0,0,0,181,179,179,179,179,179,179,179,179,179,179,179,179,179,179,179,179,179,179,179,179,179,179,179,179,179,179,179,179,179,179,179,181,48,48,0,0,0,0,0,0,0,181,179,179,179,179,179,179,179,181,48,48,48,48,48,48,48,48,48,48,48,48,48,48,48,48,48,48,48,48,48,48,48,48,48,48,48,48
0,0,0,0,0,0,0,0,0,0,0,0,0,0,0,0,0,0,0,0,0,0,181,179,179,179,179,179,179,179,179,179,179,179,179,179,179,179,179,179,179,179,179,179,179,179,179,179,179,179,179,179,181,48,48,0,0,0,0,0,0,0,0,0,181,179,179,179,179,179,179,179,181,48,48,48,48,48,48,48,48,48,48,48,48,48,48,48,48,48,48,48,48,48,48,48,48,48,48,48
0,0,0,0,0,0,0,0,0,0,0,0,0,0,0,0,0,0,0,0,0,0,0,181,179,179,179,179,179,179,155,155,155,155,155,179,179,179,179,179,179,179,179,179,179,179,179,179,179,179,179,181,48,48,0,0,0,0,0,0,0,0,0,0,181,181,179,179,179,179,179,179,179,181,48,48,48,48,48,48,48,48,48,48,48,48,48,48,48,48,48,48,48,48,48,48,48,48,48,48
0,0,0,0,0,0,0,0,0,0,0,0,0,0,0,0,0,0,0,0,0,0,0,0,181,179,179,179,179,179,179,179,179,179,179,179,179,179,179,179,179,179,179,179,179,179,179,179,179,179,181,48,48,0,0,0,0,0,0,0,0,0,0,0,0,181,181,179,179,179,179,179,179,179,181,48,48,48,48,48,48,48,48,48,48,48,48,48,48,48,48,48,48,48,48,48,48,48,48,48
0,0,0,0,0,0,0,0,0,0,0,0,0,0,0,0,0,0,0,0,0,0,0,0,48,181,179,179,179,179,179,179,179,179,179,179,179,179,179,155,155,155,155,179,179,179,179,179,179,181,48,48,0,0,0,0,0,0,0,0,0,0,0,0,0,0,0,181,179,179,179,179,179,179,179,181,48,48,48,48,48,48,48,48,48,48,48,48,48,48,48,48,48,48,48,48,48,48,48,48
0,0,0,0,0,0,0,0,0,0,0,0,0,0,0,0,0,0,0,0,0,0,0,0,48,48,181,179,179,179,179,179,179,179,179,179,179,179,179,179,179,179,155,179,179,179,179,179,181,48,48,0,0,0,0,0,0,0,0,0,0,0,0,0,0,0,0,0,181,179,179,179,179,179,179,179,181,48,48,48,48,48,48,48,48,48,48,48,48,48,48,48,48,48,48,48,48,48,48,48
0,0,0,0,0,0,0,0,0,0,0,0,0,0,0,0,0,0,0,0,0,0,0,0,0,48,48,181,179,179,179,179,179,179,179,179,179,179,179,179,179,179,179,179,179,179,179,181,48,48,0,0,0,0,0,0,0,0,0,0,0,0,0,0,0,0,0,0,0,181,179,179,179,179,179,179,179,181,48,48,48,48,48,48,48,48,48,48,48,48,48,48,48,48,48,48,48,48,48,48
0,0,0,0,0,0,0,0,0,0,0,0,0,0,0,0,0,0,0,0,0,0,0,0,0,0,48,48,181,179,179,179,179,179,179,179,179,179,179,179,179,179,179,179,179,179,181,48,48,0,0,0,0,0,0,0,0,0,0,0,0,0,0,0,0,0,0,0,0,0,181,179,179,179,179,179,179,179,181,48,48,48,48,48,48,48,48,48,48,48,48,48,48,48,48,48,48,48,48,48
0,0,0,0,0,0,0,0,0,0,0,0,0,0,0,0,0,0,0,0,0,0,0,0,0,0,0,48,48,181,181,181,181,179,179,179,179,179,179,179,179,179,181,181,181,181,48,48,0,0,0,0,0,0,0,0,184,0,0,0,0,0,0,0,0,0,0,0,0,0,0,181,179,179,179,179,179,179,179,181,181,181,181,181,181,181,181,181,181,181,181,181,181,181,181,181,181,48,48,48
0,0,0,0,0,0,0,0,0,0,0,0,0,0,0,0,0,0,0,0,0,0,0,0,0,0,0,0,48,48,48,48,48,181,179,179,179,179,179,179,179,181,48,48,48,48,48,0,0,0,0,0,0,0,0,0,0,0,0,0,0,0,0,0,0,0,0,0,0,0,0,0,181,179,179,179,179,179,179,179,179,179,179,179,179,179,179,179,179,179,179,179,179,179,179,179,179,181,48,48
0,0,0,0,0,0,0,0,0,0,0,0,0,0,0,0,0,0,0,0,0,0,0,0,0,0,0,0,48,48,48,48,48,181,179,179,179,179,179,179,179,181,48,0,0,0,0,0,0,0,0,0,0,0,0,0,0,0,0,0,0,0,0,0,0,0,0,0,0,0,0,0,181,179,179,179,179,179,179,179,179,179,179,179,179,179,179,179,179,179,179,179,179,179,179,179,179,179,181,48
0,0,0,0,0,0,0,0,0,0,0,0,0,0,0,0,0,0,0,0,0,0,0,0,0,0,0,0,0,0,0,0,0,181,0,0,0,0,0,0,0,181,0,0,0,0,0,0,0,153,0,0,0,0,0,0,0,0,0,0,0,0,0,0,0,0,0,0,0,0,0,0,181,179,179,179,179,179,179,179,179,179,179,179,179,179,179,179,179,179,179,179,179,179,179,179,179,179,179,181
0,0,0,0,0,0,0,0,0,0,0,0,0,0,0,0,0,0,0,0,0,0,0,0,0,0,0,0,0,0,0,0,0,181,0,0,0,0,0,0,0,181,0,0,0,0,0,0,0,0,0,0,0,0,0,0,0,0,0,0,0,0,0,0,0,0,0,0,0,0,0,0,181,179,179,179,179,179,179,179,179,179,179,179,179,179,179,179,179,179,179,179,179,179,179,179,179,179,179,181
0,0,0,0,116,116,116,116,0,0,0,0,0,0,0,0,0,0,0,0,0,0,0,0,0,0,0,0,0,0,0,0,0,181,0,0,0,0,0,0,0,181,0,0,0,0,0,0,0,0,0,0,0,0,0,0,0,0,0,0,0,0,0,0,0,0,0,0,0,0,0,181,179,179,179,179,179,179,179,179,179,179,179,179,179,179,179,179,179,179,179,179,179,179,179,179,179,179,181,181
0,0,0,116,0,0,0,0,116,0,0,0,0,0,0,0,0,0,0,0,0,0,0,0,0,0,0,0,0,0,0,0,0,181,0,0,0,0,0,0,0,0,0,0,0,0,0,0,0,0,0,0,0,0,0,0,0,0,0,0,0,0,0,0,0,0,0,0,0,0,181,179,179,179,179,179,179,179,179,179,179,179,179,179,179,179,179,179,179,179,179,179,179,179,179,179,179,181,48,48
0,0,116,0,0,0,0,0,0,116,0,0,0,0,0,0,0,0,0,0,0,0,0,0,0,0,0,0,0,0,0,0,0,0,0,0,0,0,0,0,0,0,0,0,0,0,0,0,0,0,0,0,0,0,0,0,0,0,0,0,0,0,0,0,0,0,0,0,0,0,0,0,0,0,179,179,179,179,179,181,181,181,181,181,181,181,181,181,181,181,181,181,181,181,181,181,181,48,48,48
0,0,116,0,116,0,116,0,0,116,0,0,0,118,0,0,0,0,0,118,0,0,0,0,0,0,0,118,118,118,118,118,118,0,0,0,0,0,0,0,0,118,118,0,0,0,0,0,0,0,0,0,0,0,0,0,0,0,0,0,0,0,0,0,0,0,0,0,0,0,0,0,0,0,0,0,0,0,181,48,48,48,48,48,48,48,48,48,48,48,48,48,48,48,48,48,48,48,48,48
0,0,116,0,0,0,0,0,0,116,0,0,0,0,118,0,0,0,118,0,0,0,0,0,0,118,118,118,118,118,118,118,118,118,118,0,0,0,0,0,118,118,118,118,0,0,0,0,0,0,0,0,0,0,0,0,0,0,0,0,0,0,0,0,0,0,0,0,0,0,0,0,0,0,0,0,0,181,48,48,48,48,48,48,48,48,48,48,48,48,48,48,48,48,48,48,48,48,48,48
0,116,116,0,0,0,0,116,0,116,0,0,0,118,118,118,118,118,118,118,0,0,0,0,118,118,118,118,118,118,118,118,118,118,118,118,0,0,0,118,118,118,118,118,118,0,0,0,0,0,0,0,0,0,0,0,0,0,0,0,0,0,0,0,0,0,0,0,0,0,0,0,0,0,0,0,0,181,0,48,48,48,48,181,181,181,181,181,181,48,48,48,48,48,48,48,48,48,48,48
0,116,0,116,116,116,116,0,0,116,0,0,118,118,0,118,118,118,0,118,118,0,0,0,118,118,118,0,0,118,118,0,0,118,118,118,0,0,118,118,0,118,118,0,118,118,0,0,0,0,0,0,0,0,0,0,0,0,0,0,0,0,0,0,0,0,0,0,0,0,0,0,0,0,0,0,0,181,0,0,0,0,181,179,179,179,179,179,179,181,48,48,48,48,48,48,48,48,48,48
0,116,0,0,0,0,0,0,0,116,0,118,118,118,118,118,118,118,118,118,118,118,0,0,118,118,118,118,118,118,118,118,118,118,118,118,0,0,118,118,118,118,118,118,118,118,0,0,0,0,0,0,0,0,0,0,0,0,0,0,0,0,0,0,0,0,0,0,0,0,0,0,0,0,0,0,0,179,181,0,0,181,179,179,179,179,179,179,179,179,181,48,48,48,48,48,48,48,48,48
0,116,116,116,116,116,116,116,116,116,0,118,0,118,118,118,118,118,118,118,0,118,0,0,0,0,0,118,118,0,0,118,118,0,0,0,0,0,0,0,118,0,0,118,0,0,0,0,0,0,0,0,0,0,0,0,0,0,0,0,0,0,0,0,0,0,0,0,0,0,0,0,0,0,0,0,0,179,179,181,181,179,179,179,179,179,179,179,179,179,179,181,181,181,181,181,181,181,48,48
0,0,0,0,0,0,0,0,0,0,0,118,0,118,0,0,0,0,0,118,0,118,0,0,0,0,118,118,0,118,118,0,118,118,0,0,0,0,0,118,0,118,118,0,118,0,0,0,0,0,0,0,0,0,0,0,0,0,0,0,0,0,0,0,0,0,0,0,0,0,0,0,0,0,0,0,0,179,179,179,179,179,179,179,181,181,181,181,179,179,179,179,179,179,179,179,179,179,181,48
0,0,0,0,0,0,0,0,0,0,0,0,0,0,118,118,0,118,118,0,0,0,0,0,118,118,0,0,0,0,0,0,0,0,118,118,0,0,118,0,118,0,0,118,0,118,0,0,0,0,0,0,0,0,0,0,0,0,0,0,0,0,0,0,0,0,0,0,0,0,0,0,0,0,0,0,0,179,179,179,179,179,179,181,48,48,48,48,181,179,179,179,179,179,179,179,179,179,179,181
0,0,0,0,0,0,0,0,0,0,0,0,0,0,0,0,0,0,0,0,0,0,0,0,0,0,0,0,0,0,0,0,0,0,0,0,0,0,0,0,0,0,0,0,0,0,0,0,0,0,0,0,0,0,0,0,0,0,0,0,0,0,0,0,0,0,0,0,0,0,0,0,0,0,0,0,0,179,179,179,179,179,181,48,48,48,48,48,48,181,179,179,179,179,179,179,179,179,179,181
0,0,0,0,0,0,0,0,0,0,0,0,0,0,0,0,0,0,0,0,0,0,0,0,0,0,0,0,0,0,0,0,0,0,0,0,0,0,0,0,0,0,0,0,0,0,0,0,0,0,0,0,0,0,0,0,0,0,0,0,0,0,0,0,0,0,0,0,0,0,0,0,0,0,0,0,0,0,181,181,181,181,48,48,48,48,48,48,48,48,181,181,181,181,179,179,179,179,179,181
0,0,0,0,0,0,0,0,0,0,0,0,0,0,0,0,0,0,0,0,0,0,0,0,0,0,0,0,0,0,0,0,0,0,0,0,0,0,0,0,0,0,0,0,0,0,0,0,0,0,0,0,0,0,0,0,0,0,0,0,0,0,0,0,0,0,0,0,0,0,0,0,0,0,0,0,0,0,0,0,0,0,48,48,48,48,48,48,48,48,48,48,48,48,181,179,179,179,179,181
0,0,0,0,0,0,0,0,0,0,0,0,0,0,0,0,0,0,0,0,0,0,0,0,0,0,0,0,0,0,0,0,0,0,0,0,0,0,0,0,0,0,0,0,0,0,0,0,0,0,0,0,0,0,0,0,0,0,0,0,0,0,0,0,0,0,0,0,0,0,0,0,0,0,0,0,0,0,0,0,0,0,48,48,48,48,48,48,48,48,181,181,181,181,181,179,179,179,179,181
0,0,0,0,0,0,0,0,0,0,0,0,0,0,0,0,0,0,0,0,0,0,0,0,0,0,0,0,0,0,0,0,0,0,0,0,0,0,0,0,0,0,0,0,0,0,0,0,0,0,0,0,0,0,0,0,0,0,0,0,0,0,0,0,0,0,0,0,0,0,0,0,0,0,0,0,0,0,0,0,0,0,48,48,48,48,48,48,48,181,179,179,179,179,179,179,179,179,179,181
0,0,0,0,0,0,0,0,0,0,0,0,0,0,0,0,0,0,0,0,0,0,0,0,0,0,0,0,0,0,0,0,0,0,0,0,0,0,0,0,0,0,0,0,0,0,0,0,0,0,0,0,0,0,0,0,0,0,0,0,0,0,0,0,0,0,0,0,0,0,0,0,0,0,0,0,0,0,0,0,0,0,48,48,48,48,48,48,48,181,179,179,179,179,179,179,179,179,179,181
0,0,0,0,0,0,0,0,0,0,0,0,0,0,0,0,0,0,0,0,0,0,0,0,0,0,0,0,0,0,0,0,0,0,0,0,0,0,0,0,0,0,0,0,0,0,0,0,0,0,0,0,0,0,0,0,0,0,0,0,0,0,0,0,0,0,0,0,0,0,0,0,0,0,0,0,0,0,0,0,0,0,48,48,48,48,48,48,48,48,181,181,181,181,181,181,181,181,181,48
}


collision {
(96,192),(128,160),(128,192),(96,192),(96,192),(96,384),(96,192)
(288,160),(128,160),(288,160)
(320,192),(288,160),(288,192),(320,192)
(1344,0),(1344,32),(1312,32),(1312,96),(1344,96),(1344,224),(320,192),(320,224),(1344,0)
(1504,0),(1504,32),(1536,32),(1536,96),(1504,96),(1504,224),(1920,224),(1504,0)
(2560,0),(2560,32),(2528,32),(2528,320),(2560,320),(2560,352),(2688,352),(2688,320),(2720,320),(2720,224),(2752,224),(2752,192),(2848,192),(2848,224),(2880,224),(2880,256),(2912,256),(2912,352),(2880,352),(2880,384),(2848,384),(2848,416),(2080,416),(2080,384),(2048,384),(2048,352),(2016,352),(2016,320),(1984,320),(1984,288),(1952,288),(1952,256),(1920,256),(1920,224),(2560,0)
(3104,224),(3072,224),(3072,192),(3040,192),(3040,160),(3008,160),(3008,128),(2976,128),(2976,64),(2944,64),(2944,32),(2912,32),(2912,0),(3104,224)
(2880,608),(2048,608),(2048,576),(2016,576),(2016,544),(1984,544),(1984,512),(1952,512),(1952,480),(1920,480),(1920,448),(1888,448),(1888,416),(1344,416),(1344,672),(1472,672),(2880,608)
(3104,384),(3072,384),(3072,416),(3040,416),(3040,448),(3008,448),(3008,480),(2976,480),(2976,512),(2944,512),(2944,544),(2912,544),(2912,576),(2880,576),(2880,608),(3104,384)
(3104,224),(3104,384),(3104,224)
(128,416),(128,384),(96,384),(128,416)
(288,416),(128,416),(288,416)
(864,768),(864,736),(896,736),(896,704),(928,704),(928,672),(1056,672),(1056,352),(320,352),(320,384),(288,384),(288,416),(864,768)
}

spawns {
(1,160,288);(0,192,256)
}

waypoints {
(224,288)
}

guns {
}
